1 1 1 1 1 1 1 1 1 1 1
1 14 7 7 7 7 7 13 7 7 1
1 7 7 7 7 7 7 7 7 7 1
1 7 7 7 7 7 7 7 7 7 1
1 7 7 7 7 7 7 7 7 7 1
1 7 7 7 7 7 7 7 7 7 1
1 7 7 7 7 7 7 7 7 7 1
1 7 7 7 7 7 7 7 7 7 1
1 7 7 7 7 7 18 16 17 7 1
1 7 7 7 7 7 7 7 7 7 1
1 1 1 1 1 11 11 1 1 1 1